Beijing	北京
Shanghai	上海
Tianjin	天津
Hong Kong	香港特别行政区
Macau	澳门特别行政区
Anqing	安庆
Bengbu	蚌埠
Bozhou	亳州
Chaohu	巢湖
Chizhou	池州
Chuzhou	滁州
Fuyang	阜阳
Hefei	合肥
Huaibei	淮北
Huainan	淮南
Huangshan	黄山
Jieshou	界首
Lu'an	六安
Ma'anshan	马鞍山
Mingguang	明光
Ningguo	宁国
Suzhou	宿州
Tianchang	天长
Tongcheng	桐城
Tongling	铜陵
Wuhu	芜湖
Xuancheng	宣城
Changle	长乐
Fu'an	福安
Fuding	福鼎
Fuqing	福清
Fuzhou	福州
Jian'ou	建瓯
Jinjiang	晋江
Longhai	龙海
Longyan	龙岩
Nan'an	南安
Nanping	南平
Ningde	宁德
Putian	莆田
Quanzhou	泉州
Sanming	三明
Shaowu	邵武
Shishi	石狮
Wuyishan	武夷山
Xiamen	厦门
Yong'an	永安
Zhangzhou	漳州
Zhangping	漳平
Baiyin	白银
Dingxi	定西
Dunhuang	敦煌
Hezuo	合作
Jiayuguan	嘉峪关
Jinchang	金昌
Jiuquan	酒泉
Lanzhou	兰州
Linxia	临夏
Longnan	陇南
Pingliang	平凉
Qingyang	庆阳
Tianshui	天水
Wuwei	武威
Yumen	玉门
Zhangye	张掖
Chaozhou	潮州
Dongguan	东莞
Enping	恩平
Foshan	佛山
Gaoyao	高要
Gaozhou	高州
Guangzhou	广州
Heshan	鹤山
Heyuan	河源
Huazhou	化州
Huizhou	惠州
Jiangmen	江门
Jieyang	揭阳
Kaiping	开平
Lechang	乐昌
Leizhou	雷州
Lianjiang	廉江
Lianzhou	连州
Lufeng	陆丰
Luoding	罗定
Maoming	茂名
Meizhou	梅州
Nanxiong	南雄
Puning	普宁
Qingyuan	清远
Shantou	汕头
Shanwei	汕尾
Shaoguan	韶关
Shenzhen	深圳
Sihui	四会
Taishan	台山
Wuchuan	吴川
Xingning	兴宁
Xinyi	信宜
Yangchun	阳春
Yangjiang	阳江
Yingde	英德
Yunfu	云浮
Zhanjiang	湛江
Zhaoqing	肇庆
Zhongshan	中山
Zhuhai	珠海
Baise	百色
Beihai	北海
Beiliu	北流
Cenxi	岑溪
Chongzuo	崇左
Dongxing	东兴
Fangchenggang	防城港
Guigang	贵港
Guilin	桂林
Guiping	桂平
Hechi	河池
Heshan	合山
Hezhou	贺州
Laibin	来宾
Liuzhou	柳州
Nanning	南宁
Pingxiang	凭祥
Qinzhou	钦州
Wuzhou	梧州
Yulin, Guangxi	玉林
Yizhou	宜州
Anshun	安顺
Bijie	毕节
Chishui	赤水
Duyun	都匀
Fuquan	福泉
Guiyang	贵阳
Kaili	凯里
Liupanshui	六盘水
Qingzhen	清镇
Renhuai	仁怀
Tongren	铜仁
Xingyi	兴义
Zunyi	遵义
Danzhou	儋州
Dongfang	东方
Haikou	海口
Qionghai	琼海
Sansha	三沙
Sanya	三亚
Wanning	万宁
Wenchang	文昌
Wuzhishan	五指山
Anguo	安国
Baoding	保定
Bazhou	霸州
Botou	泊头
Cangzhou	沧州
Chengde	承德
Dingzhou	定州
Gaobeidian	高碑店
Handan	邯郸
Hengshui	衡水
Hejian	河间
Huanghua	黄骅
Jinzhou	晋州
Jizhou	冀州
Langfang	廊坊
Luquan	鹿泉
Nangong	南宫
Qian'an	迁安
Qinhuangdao	秦皇岛
Renqiu	任丘
Shahe	沙河
Sanhe	三河
Shenzhou	深州
Shijiazhuang	石家庄
Tangshan	唐山
Xinji	辛集
Wu'an	武安
Xingtai	邢台
Xinle	新乐
Zhangjiakou	张家口
Zhuozhou	涿州
Zunhua	遵化
Anda	安达
Bei'an	北安
Daqing	大庆
Fujin	富锦
Hailin	海林
Hailun	海伦
Harbin	哈尔滨
Hegang	鹤岗
Heihe	黑河
Hulin	虎林
Jiamusi	佳木斯
Jixi	鸡西
Mishan	密山
Mudanjiang	牡丹江
Muling	穆棱
Nehe	讷河
Ning'an	宁安
Qiqihar	齐齐哈尔
Qitaihe	七台河
Shangzhi	尚志
Shuangyashan	双鸭山
Suifenhe	绥芬河
Suihua	绥化
Tieli	铁力
Tongjiang	同江
Wuchang	五常
Wudalianchi	五大连池
Yichun	伊春
Zhaodong	肇东
Anyang	安阳
Changge	长葛
Dengfeng	登封
Dengzhou	邓州
Gongyi	巩义
Hebi	鹤壁
Huixian	辉县
Jiaozuo	焦作
Jiyuan	济源
Kaifeng	开封
Lingbao	灵宝
Linzhou	林州
Luohe	漯河
Luoyang	洛阳
Mengzhou	孟州
Nanyang	南阳
Pingdingshan	平顶山
Puyang	濮阳
Qinyang	沁阳
Ruzhou	汝州
Sanmenxia	三门峡
Shangqiu	商丘
Weihui	卫辉
Wugang	舞钢
Xiangcheng	项城
Xingyang	荥阳
Xinmi	新密
Xinxiang	新乡
Xinyang	信阳
Xinzheng	新郑
Xuchang	许昌
Yanshi	偃师
Yima	义马
Yongcheng	永城
Yuzhou	禹州
Zhengzhou	郑州
Zhoukou	周口
Zhumadian	驻马店
Anlu	安陆
Chibi	赤壁
Dangyang	当阳
Danjiangkou	丹江口
Daye	大冶
Enshi	恩施
Ezhou	鄂州
Guangshui	广水
Hanchuan	汉川
Honghu	洪湖
Huanggang	黄冈
Huangshi	黄石
Jingmen	荆门
Jingzhou	荆州
Laohekou	老河口
Lichuan	利川
Macheng	麻城
Qianjiang	潜江
Shennongjia	神农架林区
Shishou	石首
Shiyan	十堰
Suizhou	随州
Songzi	松滋
Tianmen	天门
Wuhan	武汉
Wuxue	武穴
Xiangyang	襄阳
Xianning	咸宁
Xiantao	仙桃
Xiaogan	孝感
Yichang	宜昌
Yicheng	宜城
Yidu	宜都
Yingcheng	应城
Zaoyang	枣阳
Zhijiang	枝江
Zhongxiang	钟祥
Changde	常德
Changning	常宁
Changsha	长沙
Chenzhou	郴州
Hengyang	衡阳
Hongjiang	洪江
Huaihua	怀化
Jinshi	津
Jishou	吉首
Leiyang	耒阳
Lengshuijiang	冷水江
Lianyuan	涟源
Liling	醴陵
Linxiang	临湘
Liuyang	浏阳
Loudi	娄底
Miluo	汨罗
Shaoshan	韶山
Shaoyang	邵阳
Wugang	武冈
Xiangtan	湘潭
Xiangxiang	湘乡
Yiyang	益阳
Yongzhou	永州
Yuanjiang	沅江
Yueyang	岳阳
Zhangjiajie	张家界
Zhuzhou	株洲
Zixing	资兴
Arxan	阿尔山
Baotou	包头
Bayannur	巴彦淖尔
Chifeng	赤峰
Erenhot	二连浩特
Fengzhen	丰镇
Ergun	额尔古纳
Genhe	根河
Hohhot	呼和浩特
Holingol	霍林郭勒
Hulunbuir	呼伦贝尔
Manzhouli	满洲里
Ordos	鄂尔多斯
Tongliao	通辽
Ulanhot	乌兰浩特
Ulanqab	乌兰察布
Wuhai	乌海
Xilinhot	锡林浩特
Yakeshi	牙克石
Zhalantun	扎兰屯
Changshu	常熟
Changzhou	常州
Dafeng	大丰
Danyang	丹阳
Dongtai	东台
Gaoyou	高邮
Haimen	海门
Huai'an	淮安
Jiangyin	江阴
Jingjiang	靖江
Jintan	金坛
Jurong	句容
Liyang	溧阳
Lianyungang	连云港
Kunshan	昆山
Nanjing	南京
Nantong	南通
Pizhou	邳州
Qidong	启东
Rugao	如皋
Suqian	宿迁
Suzhou	苏州
Taicang	太仓
Taizhou	泰州
Taixing	泰兴
Wuxi	无锡
Xinyi	新沂
Xinghua	兴化
Xuzhou	徐州
Yancheng	盐城
Yangzhong	扬中
Yangzhou	扬州
Yixing	宜兴
Yizheng	仪征
Zhangjiagang	张家港
Zhenjiang	镇江
Dexing	德兴
Fengcheng	丰城
Fuzhou	抚州
Ganzhou	赣州
Gao'an	高安
Guixi	贵溪
Ji'an	吉安
Jingdezhen	景德镇
Jinggangshan	井冈山
Jiujiang	九江
Leping	乐平
Nanchang	南昌
Pingxiang	萍乡
Ruichang	瑞昌
Ruijin	瑞金
Shangrao	上饶
Xinyu	新余
Yingtan	鹰潭
Yichun	宜春
Zhangshu	樟树
Baicheng	白城
Baishan	白山
Changchun	长春
Da'an	大安
Dehui	德惠
Dunhua	敦化
Fuyu	扶余
Gongzhuling	公主岭
Helong	和龙
Huadian	桦甸
Hunchun	珲春
Ji'an	集安
Jiaohe	蛟河
Jilin	吉林
Liaoyuan	辽源
Linjiang	临江
Longjing	龙井
Meihekou	梅河口
Panshi	磐石
Shuangliao	双辽
Shulan	舒兰
Siping	四平
Songyuan	松原
Taonan	洮南
Tonghua	通化
Tumen	图们
Yanji	延吉
Yushu	榆树
Anshan	鞍山
Benxi	本溪
Beipiao	北票
Beizhen	北镇
Chaoyang	朝阳
Dalian	大连
Dandong	丹东
Dashiqiao	大石桥
Dengta	灯塔
Diaobingshan	调兵山
Donggang	东港
Fengcheng	凤城
Fushun	抚顺
Fuxin	阜新
Gaizhou	盖州
Haicheng	海城
Huludao	葫芦岛
Jinzhou	锦州
Kaiyuan	开原
Liaoyang	辽阳
Linghai	凌海
Lingyuan	凌源
Panjin	盘锦
Pulandian	普兰店
Shenyang	沈阳
Tieling	铁岭
Wafangdian	瓦房店
Xingcheng	兴城
Xinmin	新民
Yingkou	营口
Zhuanghe	庄河
Guyuan	固原
Lingwu	灵武
Qingtongxia	青铜峡
Shizuishan	石嘴山
Wuzhong	吴忠
Yinchuan	银川
Zhongwei	中卫
Delhi	德令哈
Golmud	格尔木
Haidong	海东
Xining	西宁
Yushu	玉树
Ankang	安康
Baoji	宝鸡
Hancheng	韩城
Hanzhong	汉中
Huayin	华阴
Shangluo	商洛
Tongchuan	铜川
Xi'an	西安
Xianyang	咸阳
Xingping	兴平
Weinan	渭南
Yan'an	延安
Yulin	榆林
Anqiu	安丘
Binzhou	滨州
Changyi	昌邑
Dezhou	德州
Dongying	东营
Feicheng	肥城
Gaomi	高密
Haiyang	海阳
Heze	菏泽
Jiaozhou	胶州
Jinan	济南
Jining	济宁
Jimo	即墨
Laiwu	莱芜
Laixi	莱西
Laiyang	莱阳
Laizhou	莱州
Leling	乐陵
Liaocheng	聊城
Linqing	临清
Linyi	临沂
Longkou	龙口
Penglai	蓬莱
Pingdu	平度
Qingdao	青岛
Qingzhou	青州
Qixia	栖霞
Qufu	曲阜
Rongcheng	荣成
Rizhao	日照
Rushan	乳山
Shouguang	寿光
Tai'an	泰安
Tengzhou	滕州
Weifang	潍坊
Weihai	威海
Xintai	新泰
Yantai	烟台
Yucheng	禹城
Zaozhuang	枣庄
Zhaoyuan	招远
Zhucheng	诸城
Zoucheng	邹城
Zhangqiu	章丘
Zibo	淄博
Changzhi	长治
Datong	大同
Fenyang	汾阳
Gaoping	高平
Gujiao	古交
Hejin	河津
Houma	侯马
Huozhou	霍州
Jiexiu	介休
Jincheng	晋城
Jinzhong	晋中
Linfen	临汾
Lucheng	潞城
Lüliang	吕梁
Shuozhou	朔州
Taiyuan	太原
Xiaoyi	孝义
Xinzhou	忻州
Yangquan	阳泉
Yongji	永济
Yuncheng	运城
Yuanping	原平
Bazhong	巴中
Chengdu	成都
Chongzhou	崇州
Dazhou	达州
Deyang	德阳
Dujiangyan	都江堰
Emeishan	峨眉山
Guang'an	广安
Guanghan	广汉
Guangyuan	广元
Huaying	华蓥
Jiangyou	江油
Jianyang	简阳
Kangding	康定
Langzhong	阆中
Leshan	乐山
Luzhou	泸州
Mianzhu	绵竹
Meishan	眉山
Mianyang	绵阳
Neijiang	内江
Nanchong	南充
Panzhihua	攀枝花
Pengzhou	彭州
Qionglai	邛崃
Shifang	什邡
Suining	遂宁
Wanyuan	万源
Xichang	西昌
Ya'an	雅安
Yibin	宜宾
Zigong	自贡
Ziyang	资阳
Lhasa	拉萨
Xigazê	日喀则
Qamdo	昌都
Nyingchi	林芝
Aksu	阿克苏
Alashankou	阿拉山口
Altay	阿勒泰
Aral	阿拉尔
Artux	阿图什
Beitun	北屯
Bole	博乐
Changji	昌吉
Fukang	阜康
Yining	伊宁
Hotan	和田
Karamay	克拉玛依
Kashgar	喀什
Korgas	霍尔果斯
Kokdala	可克达拉
Korla	库尔勒
Kumul	哈密
Kuytun	奎屯
Shihezi	石河子
Shuanghe	双河
Tumxuk	图木舒克
Tacheng	塔城
Tiemenguan	铁门关
Turpan	吐鲁番
ürümqi	乌鲁木齐
Wujiaqu	五家渠
Wusu	乌苏
Anning	安宁
Baoshan	保山
Chuxiong	楚雄
Dali	大理
Gejiu	个旧
Jinghong	景洪
Kaiyuan	开远
Kunming	昆明
Lincang	临沧
Lijiang	丽江
Mang	芒
Mengzi	蒙自
Mile	弥勒
Pu'er	普洱
Qujing	曲靖
Ruili	瑞丽
Shangri-La	香格里拉
Xuanwei	宣威
Yuxi	玉溪
Zhaotong	昭通
Cixi	慈溪
Dongyang	东阳
Fenghua	奉化
Haining	海宁
Hangzhou	杭州
Huzhou	湖州
Jiande	建德
Jiangshan	江山
Jiaxing	嘉兴
Jinhua	金华
Lanxi	兰溪
Longquan	龙泉
Lin'an	临安
Linhai	临海
Lishui	丽水
Ningbo	宁波
Pinghu	平湖
Quzhou	衢州
Ruian	瑞安
Shaoxing	绍兴
Shengzhou	嵊州
Taizhou	台州
Tongxiang	桐乡
Wenling	温岭
Wenzhou	温州
Yueqing	乐清
Yongkang	永康
Yiwu	义乌
Yuyao	余姚
Zhoushan	舟山
Zhuji	诸暨